........
........
.X......
###.....
........
......G.
.....###
........
.G......
###.....
........
......G.
.....###
........
1.......
########
